111111111111111111111111111111111111111111111111111111
1EC000001000000000000000000000000C00000000000000000011
100000111000000000000000000000000000000000000000011111
1P0000000000000000000000000000000000000000000000000001
1011C1111100000000000000000000001C10000000000000000001
10C00000000000000000000000000000000000000000C000000001
100000000000000000000000000000000000000000000000000001
1000000000000000000000000000000000C0000000000000000001
100C000000000000000000000000000000000000000000000000E1
111111111111111111111111111111111111111111111111111111