1111111111111111111111111111111111
111E000000000010100000000000000001
1000010100100000111001000000010101
10100100101P1010001001000000010111
10C0000000000000000000000000000001
1111111111111111111111111111111111
P