11111111
10C00111
1P000011
100E0011
1111C111
10C00011
11111111