111111111
10C010001
1000E10P1
100010001
1C000C001
111111111