111111111
10C000001
1000E00P1
111100001
1C0000011
111111111
