1111111111
10010P1C11
1001001C11
1100000001
1010100001
1110111111
1100000001
1000100001
1101111111
1001001C11
1100000001
1010100001
1111111011
1001001C11
1001001C11
1100000001
1010100001
1111110111
1100000001
1010000001
1111011111
10E1001C11
1100000001
1010100001
1111111111