1111111
10E10P1
1100C01
101C101
1111111
